7;7;7;7;7;7;7;7;7;7;7;7;7;7;7;7;7;7;7;7;7;7;7;7;7;7;7;7;7;7;7;7;7;7;7;7;7;7;7;7;7;7;7;7;7;7;7;7;7;7;7;7;7;7;7;7;7;7;7;7
7;7;7;7;7;7;7;7;7;7;7;7;7;7;7;7;7;7;7;7;7;7;7;7;7;7;7;7;7;7;7;7;7;7;7;7;7;7;7;7;7;7;7;7;7;7;7;7;7;7;7;7;7;7;7;7;7;7;7;7
7;7;38;38;38;38;38;38;38;38;38;38;38;7;7;7;7;7;7;7;7;7;7;7;7;7;7;7;7;7;7;7;38;38;38;38;38;38;38;38;38;38;38;38;38;38;7;7;7;7;7;38;38;38;38;38;38;38;38;38
7;7;38;38;38;38;38;38;38;38;38;38;38;7;7;7;7;7;7;7;7;7;7;7;7;7;7;7;7;7;7;7;38;38;38;38;38;38;38;38;38;38;38;38;38;38;7;7;7;7;7;38;38;38;38;38;38;38;38;38
7;7;38;38;38;38;38;38;38;38;38;38;38;7;7;7;7;7;7;7;7;7;7;7;7;7;7;7;7;7;7;7;38;38;38;38;38;38;38;38;38;38;38;38;38;38;7;7;7;7;7;38;38;38;38;38;38;38;38;38
7;7;38;38;38;7;7;7;7;7;38;38;38;7;7;7;7;7;7;7;7;7;7;7;7;7;7;7;7;7;7;7;38;38;38;7;7;7;7;7;7;7;7;38;38;38;7;7;7;7;7;38;38;38;7;7;7;7;7;7
7;7;38;38;38;7;7;7;7;7;38;38;38;38;38;38;38;38;38;38;38;38;38;38;38;38;38;38;7;7;7;7;38;38;38;7;7;7;7;7;7;7;7;38;38;38;7;7;7;7;7;38;38;38;7;7;7;7;7;7
7;7;38;38;38;7;7;7;7;7;38;38;38;38;38;38;38;38;38;38;38;38;38;38;38;38;38;38;7;7;7;7;38;38;38;7;7;7;7;7;7;7;7;38;38;38;7;7;7;7;7;38;38;38;7;7;7;7;7;7
7;7;38;38;38;7;7;7;7;7;38;38;38;38;38;38;38;38;38;38;38;38;38;38;38;38;38;38;7;7;7;7;38;38;38;7;7;7;7;7;7;7;7;38;38;38;7;7;7;7;7;38;38;38;7;7;7;7;7;7
7;7;38;38;38;7;7;7;7;7;7;7;7;7;7;7;7;7;7;7;7;7;7;7;7;38;38;38;7;7;7;7;38;38;38;38;38;38;38;7;7;7;7;38;38;38;7;7;7;7;7;38;38;38;7;7;7;7;7;7
7;7;38;38;38;7;7;7;7;7;7;7;7;7;7;7;7;7;7;7;7;7;7;7;7;38;38;38;7;7;7;7;38;38;38;38;38;38;38;7;7;7;7;38;38;38;38;38;38;38;38;38;38;38;7;7;7;7;7;7
7;7;38;38;38;7;7;7;7;7;7;7;7;7;7;7;7;7;7;7;7;7;7;7;7;38;38;38;7;7;7;7;38;38;38;38;38;38;38;7;7;7;7;38;38;38;38;38;38;38;38;38;38;38;7;7;7;7;7;7
7;7;38;38;38;7;7;7;7;7;7;7;7;7;7;7;7;7;7;7;7;7;7;7;7;38;38;38;7;7;7;7;7;7;7;7;38;38;38;7;7;7;7;38;38;38;38;38;38;38;38;38;38;38;7;7;7;7;7;7
7;7;38;38;38;38;38;38;38;38;38;38;38;38;38;38;38;38;38;38;38;7;7;7;7;38;38;38;7;7;7;7;7;7;7;7;38;38;38;7;7;7;7;7;7;7;7;7;7;7;7;7;7;7;7;7;7;7;7;7
7;7;38;38;38;38;38;38;38;38;38;38;38;38;38;38;38;38;38;38;38;7;7;7;7;38;38;38;7;7;7;7;7;7;7;7;38;38;38;7;7;7;7;7;7;7;7;7;7;7;7;7;7;7;7;7;7;7;7;7
7;7;38;38;38;38;38;38;38;38;38;38;38;38;38;38;38;38;38;38;38;7;7;7;7;38;38;38;7;7;7;7;7;7;7;7;38;38;38;7;7;7;7;7;7;7;7;7;7;7;7;7;7;7;7;7;7;7;7;7
7;7;7;7;7;7;38;38;38;7;7;7;7;7;7;7;7;7;38;38;38;7;7;7;7;38;38;38;7;7;7;7;7;7;7;7;38;38;38;7;7;7;7;7;7;7;7;7;7;7;7;7;7;7;7;7;7;7;7;7
7;7;7;7;7;7;38;38;38;7;7;7;7;7;7;7;7;7;38;38;38;38;38;38;38;38;38;38;38;38;38;38;38;38;38;38;38;38;38;38;38;38;38;38;38;38;38;38;38;7;7;7;7;7;7;7;7;7;7;7
7;7;7;7;7;7;38;38;38;7;7;7;7;7;7;7;7;7;38;38;38;38;38;38;38;38;38;38;38;38;38;38;38;38;38;38;38;38;38;38;38;38;38;38;38;38;38;38;38;7;7;7;7;7;7;7;7;7;7;7
7;7;7;7;7;7;38;38;38;7;7;7;7;7;7;7;7;7;38;38;38;38;38;38;38;38;38;38;38;38;38;38;38;38;38;38;38;38;38;38;38;38;38;38;38;38;38;38;38;7;7;7;7;7;7;7;7;7;7;7
7;7;7;7;7;7;38;38;38;7;7;7;7;7;7;7;7;7;7;7;7;7;7;7;7;38;38;38;7;7;7;7;7;7;7;7;7;7;7;7;7;7;7;7;7;7;38;38;38;7;7;7;7;7;7;7;7;7;7;7
7;7;7;7;7;7;38;38;38;7;7;7;7;7;7;7;7;7;7;7;7;7;7;7;7;38;38;38;7;7;7;7;7;7;7;7;7;7;7;7;7;7;7;7;7;7;38;38;38;7;7;7;7;7;7;7;7;7;7;7
7;7;7;7;38;38;38;38;38;38;38;7;7;7;7;7;7;7;7;7;7;7;7;7;7;38;38;38;7;7;7;7;7;7;7;7;7;7;7;7;7;7;7;7;7;7;38;38;38;7;7;7;7;7;7;7;7;7;7;7
7;7;7;7;38;38;38;38;38;38;38;7;7;7;7;7;7;7;7;7;7;7;7;7;7;38;38;38;7;7;7;7;7;7;7;7;7;7;7;7;7;7;7;7;7;7;38;38;38;38;38;38;38;38;38;38;7;7;7;7
7;7;7;7;38;38;38;38;38;38;38;7;7;7;7;7;7;7;7;7;38;38;38;38;38;38;38;38;38;38;7;7;7;7;7;7;7;7;7;7;7;7;7;7;7;7;38;38;38;38;38;38;38;38;38;38;7;7;7;7
7;7;7;7;38;38;38;38;38;38;38;7;7;7;7;7;7;7;7;7;38;38;38;38;38;38;38;38;38;38;7;7;7;7;7;7;7;38;38;38;38;38;38;38;38;38;38;38;38;38;38;38;38;38;38;38;38;38;7;7
7;7;7;7;38;38;38;38;38;38;38;38;38;38;38;38;38;38;38;38;38;38;38;38;38;38;38;38;38;38;7;7;7;7;7;7;7;38;38;38;38;38;38;38;38;38;38;38;38;7;7;7;7;38;38;38;38;38;7;7
7;7;7;7;38;38;38;38;38;38;38;38;38;38;38;38;38;38;38;38;38;38;38;7;7;7;7;38;38;38;7;7;7;7;7;7;7;38;38;38;38;38;38;38;38;38;38;38;38;7;7;7;7;38;38;38;38;38;7;7
7;7;7;7;38;38;38;38;38;38;38;38;38;38;38;38;38;38;38;38;38;38;38;7;7;7;7;38;38;38;7;7;7;7;7;7;7;38;38;38;7;7;7;7;38;38;38;7;7;7;7;7;7;7;7;38;38;38;7;7
7;7;7;7;38;38;38;7;7;7;7;7;7;7;7;7;7;7;7;7;7;7;7;7;7;7;7;38;38;38;38;38;38;38;38;38;38;38;38;38;7;7;7;7;38;38;38;7;7;7;7;7;7;7;7;38;38;38;7;7
7;7;7;7;38;38;38;7;7;7;7;7;7;7;7;7;7;7;7;7;7;7;7;7;7;7;7;38;38;38;38;38;38;38;38;38;38;38;38;38;7;7;7;7;38;38;38;7;7;7;7;7;7;7;7;38;38;38;7;7
7;7;7;7;38;38;38;7;7;7;7;7;7;7;7;7;7;7;7;7;7;7;7;7;7;7;7;38;38;38;38;38;38;38;38;38;38;38;38;38;7;7;7;7;38;38;38;7;7;7;7;7;7;7;7;38;38;38;7;7
7;7;7;7;38;38;38;7;7;7;7;7;7;7;7;7;7;7;7;7;7;7;7;7;7;7;7;38;38;38;7;7;7;7;7;7;7;38;38;38;7;7;7;7;38;38;38;7;7;7;7;7;7;7;7;38;38;38;7;7
7;7;7;7;38;38;38;38;38;38;38;7;7;7;7;38;38;38;38;38;38;38;38;38;38;38;38;38;38;38;7;7;7;7;7;7;7;38;38;38;38;38;38;38;38;38;38;7;7;7;7;38;38;38;38;38;38;38;7;7
7;7;7;7;38;38;38;38;38;38;38;7;7;7;7;38;38;38;38;38;38;38;38;38;38;38;38;38;38;38;7;7;7;7;7;7;7;38;38;38;38;38;38;38;38;38;38;7;7;7;7;38;38;38;38;38;38;38;7;7
7;7;7;7;38;38;38;38;38;38;38;7;7;7;7;38;38;38;38;38;38;38;38;38;38;38;38;38;38;38;7;7;7;7;7;7;7;38;38;38;38;38;38;38;38;38;38;7;7;7;7;38;38;38;38;38;38;38;7;7
7;7;7;7;7;7;7;7;7;7;7;7;7;7;7;7;7;7;7;7;7;7;7;7;7;7;7;7;7;7;7;7;7;7;7;7;7;7;7;7;7;7;7;7;7;7;7;7;7;7;7;7;7;7;7;7;7;7;7;7
7;7;7;7;7;7;7;7;7;7;7;7;7;7;7;7;7;7;7;7;7;7;7;7;7;7;7;7;7;7;7;7;7;7;7;7;7;7;7;7;7;7;7;7;7;7;7;7;7;7;7;7;7;7;7;7;7;7;7;7
